kaikulaitteidesi -- kaikulaite
dietyylihydroksifenyylissänsä -- dietyylihydroksifenyyli
vuosineljänneksenäni -- vuosineljännes
arkuskotangenteiksensa -- arkuskotangentti
tavaratodistuksiltasi -- tavaratodistus
aventuriineistani -- aventuriini
kvanttifysiikoidensa -- kvanttifysiikka
vaikutusaineitansa -- vaikutusaine
lyhtyjämme -- lyhty
tarttumassamme -- tarttuma
kovuuskokeistamme -- kovuuskoe
ryppyotsaisuudestanne -- ryppyotsaisuus
siimajal′oillensa -- siimajalka -----------------------------------------------------------------
ulkoerondoiksesi -- ulkoeronto
auskareistanne -- auskari
autotelineestanne -- autoteline -----------------------------------------------------------------
kääntöha′altaan -- kääntöhaka -----------------------------------------------------------------
vesiylioikeudeltaan -- vesiylioikeus
raskausviikkonani -- raskausviikko
riebekiittiänne -- riebekiitti
jokipenkerenänsä -- jokipenger
maissikakustamme -- maissikakku
vesiaktiivisuudellamme -- vesiaktiivisuus
puoliapinaksenne -- puoliapina
suuttiminaan -- suutin
uudelleenasettautumismäärärahoillaan -- uudelleenasettautumismääräraha
utareiksenne -- utare
henkilökuntaetuamme -- henkilökuntaetu
paperikooltanne -- paperikoko
megaliitiltaan -- megaliitti
fyllodioltansa -- fyllodio
bakterisidiksemme -- bakterisidi
kirgisialaisinanne -- kirgisialainen
vihereleniattanne -- viherelenia
pikkuauringonkukallenne -- pikkuauringonkukka
magnetoinnillansa -- magnetointi
yhteisöveroltasi -- yhteisövero
muinaisalasaksiinne -- muinaisalasaksi
nonparelleiksensa -- nonparelli
hierrinkiviesi -- hierrinkivi
viritykseemme -- viritys
töminöiksemme -- töminä
juhannusjuhlanaan -- juhannusjuhla
dekanamiineissani -- dekanamiini
toimittamisillaan -- toimittaminen
koirasuttasi -- koirasusi
ratajuoksuunne -- ratajuoksu
niittaamisikseni -- niittaaminen
miu’ultani -- miuku
uutispuuroosi -- uutispuuro
siankärsämöjensä -- siankärsämö
valvontatelevisiossasi -- valvontatelevisio
nikotiinihappoanne -- nikotiinihappo
talousesinettänne -- talousesine
leutoutenamme -- leutous
verkostotopologioillasi -- verkostotopologia
summaarisuuksiesi -- summaarisuus
ulpukoitani -- ulpukka
vihannessäilykkeidenne -- vihannessäilyke
valehyökkäykseksenne -- valehyökkäys
itägooteissansa -- itägootti
kaliumnitratsepaateillani -- kaliumnitratsepaatti
pukurahassasi -- pukuraha
sekopäisyydessänne -- sekopäisyys
koossapysyvyyteni -- koossapysyvyys
laumasuojiinsa -- laumasuoja
kuratointilleen -- kuratointi ------------------------------------------------------------------------
medianomeittaan -- medianomi
väkivasaroittaan -- väkivasara
linjaja'ottaan -- linjajako
kylmäfuusioissansa -- kylmäfuusio
lyhytnäköisyydekseni -- lyhytnäköisyys
mikrokuituliinoiksenne -- mikrokuituliina
evankelistoissani -- evankelista
karvassuolallemme -- karvassuola
vinopenkkipunnerrustesi -- vinopenkkipunnerrus
lehmäluvuistaan -- lehmäluku
kultasuonessansa -- kultasuoni
väännöiksensä -- vääntö
raakalaisianne -- raakalainen
sarveistumaksenne -- sarveistuma
kumiasfalttejanne -- kumiasfaltti
sinertävänvihreiksenne -- sinertävänvihreä
keskiakseliperävaununasi -- keskiakseliperävaunu
rippikoulunopettajiaan -- rippikoulunopettaja
anjovispäärynäpuikseni -- anjovispäärynäpuu
kalapiikkillanne -- kalapiikki ------------------------------------------------------------------------
faunoissamme -- fauna
ansoituksinani -- ansoitus
paratiisiomenilleen -- paratiisiomena
protektionistinansa -- protektionisti
vuorovesienergioiltani -- vuorovesienergia
seurantajärjestelmällämme -- seurantajärjestelmä
äkeenäsi -- äes
rakennustarkastuksenamme -- rakennustarkastus
libanoninsetrilläni -- libanoninsetri
ulkotakkeiksesi -- ulkotakki
varalentokenttiensä -- varalentokenttä
rääppeinänne -- rääppeet
etklorvynolikarbamaatteinani -- etklorvynolikarbamaatti
alkuperäluokituksellemme -- alkuperäluokitus
kirkkoelämänään -- kirkkoelämä
kolmiulotteisuutemme -- kolmiulotteisuus
kaprokkeistani -- kaprokki
letosteiinittaan -- letosteiini
surfaktantiksemme -- surfaktantti
kuplimisessaan -- kupliminen
syringomyelialtani -- syringomyelia
blefarospasmittaan -- blefarospasmi
sukaatittansa -- sukaatti
ulkoilmakahviloittansa -- ulkoilmakahvila
kovakalvojemme -- kovakalvo
sädesiipisimpuiltanne -- sädesiipisimppu
spesialiteettinasi -- spesialiteetti
lättäpalmikoittani -- lättäpalmikko
verotaloutenansa -- verotalous
ylioppilastodistuksinasi -- ylioppilastodistus
kontuusiossaan -- kontuusio
vahapalmuillemme -- vahapalmu
kapmaanluumuuni -- kapmaanluumu
sosiometriikallaan -- sosiometriikka
sydänkuolleisuudestansa -- sydänkuolleisuus
sätkyttelyksensä -- sätkyttely
kitkusi -- kitku
kovakuoriaisettanne -- kovakuoriainen
teollisuusministereinäsi -- teollisuusministeri
teippaustanne -- teippaus
harmaaviirukukastajittani -- harmaaviirukukastaja
merimiessäkkiinsä -- merimiessäkki
voimatalouttamme -- voimatalous
tiedekorkeakouluasi -- tiedekorkeakoulu
tenoristeistani -- tenoristi
verotaloudellanne -- verotalous
ravassaan -- rapa
tietotaitoaan -- tietotaito
lehtisahanansa -- lehtisaha
pääsyteittänne -- pääsytie
pääkallonpaikkojeni -- pääkallonpaikka
tervetuliaispuheinansa -- tervetuliaispuhe
sepelrastaittenne -- sepelrastas
lasintekijöiksenne -- lasintekijä
suunnikkaassasi -- suunnikas
depressiohäiriöillänsä -- depressiohäiriö
malmikoirastasi -- malmikoira
länsiryhmäkseen -- länsiryhmä
smalltalkiesi -- smalltalk
liikemaailmoihinne -- liikemaailma
maastoautoillansa -- maastoauto
veitsikytkimillensä -- veitsikytkin
niiskuttajinasi -- niiskuttaja
organisoinnittasi -- organisointi
douglasinpussihiiristäsi -- douglasinpussihiiri
ruhjouminasi -- ruhjouma
kisakyläksemme -- kisakylä
kasvipuristimellensa -- kasvipuristin
ammatinharjoittajaansa -- ammatinharjoittaja
siimahänniksemme -- siimahäntä
lankunpätkillään -- lankunpätkä
yleishälytyksinämme -- yleishälytys
dieselveturinanne -- dieselveturi
valkopääviuhtojallemme -- valkopääviuhtoja
laajentajastanne -- laajentaja
nakutuksenestoaineissanne -- nakutuksenestoaine
rilopiroksiansa -- rilopiroksi
atsasitidiininamme -- atsasitidiini
epidermolyysiesi -- epidermolyysi
tutkimussukellusveneillansa -- tutkimussukellusvene ------------------------------------------------------------------------------
konformisuudeltamme -- konformisuus
vuosimaksuilleni -- vuosimaksu
rockklubeinaan -- rockklubi
leivänviipaleinansa -- leivänviipale
rimputtelultamme -- rimputtelu
kystoseelestaan -- kystoseele
asukastiheyksinään -- asukastiheys
värisekoitustasi -- värisekoitus
apajinani -- apaja
laitakaupungeillesi -- laitakaupunki
ruosteperäkalastajallenne -- ruosteperäkalastaja
ruispuuroistaan -- ruispuuro
jalkainvalidissanne -- jalkainvalidi
hebrealaisillasi -- hebrealainen
viemärilinjaltaan -- viemärilinja
joenäyräällänsä -- joenäyräs
leninkikankaitteni -- leninkikangas
puoluejaottamme -- puoluejako
rantaruotsalaisekseen -- rantaruotsalainen
rypälesadoikseen -- rypälesato
aateliltanne -- aateli
kohdunkaulaansa -- kohdunkaula
heräteostoittani -- heräteosto
karkeasäätimissänsä -- karkeasäädin
luontaishoidoiltansa -- luontaishoito
synnytyspoltoilleni -- synnytyspoltto
tuubassanne -- tuuba
reformointinne -- reformointi
helmiryyneissään -- helmiryyni
kirvisinään -- kirvinen
sähköpolttojasi -- sähköpoltto
siirtolaisjärjestöillenne -- siirtolaisjärjestö
bokombaliksesi -- bokombali
yötuuliltanne -- yötuuli
asutustilallisissani -- asutustilallinen
kaksoismurhaajinaan -- kaksoismurhaaja
kimalaiskärpäsellenne -- kimalaiskärpänen
turnillenne -- turn
kysymäni -- kysymä
kiristimiämme -- kiristin
musiikkiryhmästään -- musiikkiryhmä
etelänbastardikilpikonnakseen -- etelänbastardikilpikonna
mallipukineitasi -- mallipukine
rauhanneuvottelijoillenne -- rauhanneuvottelija
junioriasemansa -- junioriasema
kostutteenanne -- kostute
brysseleillään -- brysseli
magneettikuvauksillenne -- magneettikuvaus
sähköakkumulaattoriksenne -- sähköakkumulaattori
kalseiinilleen -- kalseiini
kirjainmuodoittaan -- kirjainmuoto
molliasteikoihini -- molliasteikko
ranolatsiinissaan -- ranolatsiini
malmisuonissamme -- malmisuoni
streltsieni -- streltsi
venemalleistansa -- venemalli
elämänviisaudeksesi -- elämänviisaus
yksityispuheluistamme -- yksityispuhelu
arroganssiksenne -- arroganssi
merioikeuksinasi -- merioikeus
radiosähkötystänsä -- radiosähkötys
artisokaltanne -- artisokka
toimeenpanollasi -- toimeenpano
fysiikantunteinamme -- fysiikantunti
kyynelmaljoistaan -- kyynelmalja
kalttaamisiini -- kalttaaminen
antropofobioidenne -- antropofobia
eläytymismenetelmiinsä -- eläytymismenetelmä
tieteisleffoiltanne -- tieteisleffa
johdannoittaan -- johdanto
öljynkeräysaluksenani -- öljynkeräysalus
markkinavoimissasi -- markkinavoimat
kunnostamoideni -- kunnostamo
kehystämöiksesi -- kehystämö
dokarpamiineissamme -- dokarpamiini
täyskäännökseksensä -- täyskäännös
erieissämme -- erie
polygyniaasi -- polygynia
roksatidiiniinsa -- roksatidiini
gerontokratiastasi -- gerontokratia
manillapapereinamme -- manillapaperi
tridekyyliamiineinansa -- tridekyyliamiini
tekstiilikuitujani -- tekstiilikuitu
hönkänänne -- hönkä
lähennyksiänne -- lähennys
metyylitionansa -- metyylitio
etanolidihydrokloridimme -- etanolidihydrokloridi
bratwurstianne -- bratwurst
romanistiikattanne -- romanistiikka
edelläkävijöinäsi -- edelläkävijä
fomokaiinistaan -- fomokaiini
parkkilieminamme -- parkkiliemi
saredutanttiinsa -- saredutantti
yöunekseni -- yöuni
littorinakautenaan -- littorinakausi
pianoteoksiesi -- pianoteos
ketoheksoosiimme -- ketoheksoosi
turismissaan -- turismi
apostilloittaan -- apostilla
sedanittasi -- sedan
kruununprinsessoihimme -- kruununprinsessa
vaatelapullanne -- vaatelappu
irtaimistosi -- irtaimisto
atopognosioillasi -- atopognosia
tirkistysrei'iksensä -- tirkistysreikä
miniminopeuksillanne -- miniminopeus
keksilaatikoilleen -- keksilaatikko
höyrylaivalinjattamme -- höyrylaivalinja
keltakuumeensa -- keltakuume
pussimesipäästäisiksesi -- pussimesipäästäinen
kädensuojuksellasi -- kädensuojus
silmäkuoppianne -- silmäkuoppa
koruteollisuuksinani -- koruteollisuus
teatterinharrastajinamme -- teatterinharrastaja
cabreranhutiastaan -- cabreranhutia
vesivuoteiltaan -- vesivuode
tilapäisjulkaisuksensa -- tilapäisjulkaisu
maitiaissuonissamme -- maitiaissuoni
tuiskupyssyiltään -- tuiskupyssy
petopistiäisiemme -- petopistiäinen
vastauskuponkianne -- vastauskuponki
telmisartaanilleni -- telmisartaani
kulttielokuvillasi -- kulttielokuva
estradiolivaleraateillanne -- estradiolivaleraatti
verrytyksiltäni -- verrytys
pallomaneetiksenne -- pallomaneetti
hokkuspokkuksettamme -- hokkuspokkus
naamiokuhankeittäjistäsi -- naamiokuhankeittäjä
oksiridatsiinillamme -- oksiridatsiini
tahitistanne -- tahiti
aasiankeisarikalastajaltanne -- aasiankeisarikalastaja
täristyksellemme -- täristys
osakuntanauhoillensa -- osakuntanauha
nastarenkaanansa -- nastarengas
työntömitaltansa -- työntömitta
riukiunkalastajastanne -- riukiunkalastaja
ajotunteinanne -- ajotunti
velkaloukussamme -- velkaloukku
rehuhiivoiltasi -- rehuhiiva
häntäluupunoksiaan -- häntäluupunos
tupalaisillasi -- tupalainen
äänittäjästäsi -- äänittäjä
isobutyleeniinne -- isobutyleeni
veljeilyksensä -- veljeily
märeellään -- märe
sulkimisessansa -- sulkiminen
ylempiarvoisillensa -- ylempiarvoinen
miesvihallemme -- miesviha
gesiäsi -- ges
tuomarittanne -- tuomari
suosionaan -- suosio
muistolaatoistani -- muistolaatta
ekonomisteistamme -- ekonomisti
aniitistaan -- aniitti
oikeustapaustani -- oikeustapaus
purjeentekijöittemme -- purjeentekijä
mittavälineillään -- mittaväline
kulkuajassamme -- kulkuaika
paistiveitsilleni -- paistiveitsi
folioko'oillemme -- foliokoko
meristeemitekniikaltanne -- meristeemitekniikka
fenyyliasetamideittamme -- fenyyliasetamidi
pakkausmateriaalinsa -- pakkausmateriaali
mispachojenne -- mispacha
murtokuormituksellani -- murtokuormitus
kilvenkupuraamme -- kilvenkupura
piiteräksittään -- piiteräs
postittajananne -- postittaja
kaasukombivoimalaitoksenani -- kaasukombivoimalaitos
tapahtumasarjastasi -- tapahtumasarja
happohyökkäyksiini -- happohyökkäys
aatoksistaan -- aatos
keskialasaksaksensa -- keskialasaksa
masukseen -- masu
erikoislupastaan -- erikoislupa
tandemeinanne -- tandem
astianpesuvesillesi -- astianpesuvesi
suuntureitaan -- suunturi
maitoalbumiinissamme -- maitoalbumiini
siimajalkaisissani -- siimajalkainen
dipropyylieettereitämme -- dipropyylieetteri
poikkeusihmisieni -- poikkeusihminen
suuriherttuattarestanne -- suuriherttuatar
tunariini -- tunari
kansipaikkanamme -- kansipaikka
tuhkatöyhtönapsijoihinne -- tuhkatöyhtönapsija
suojasatamaamme -- suojasatama
gastruloissaan -- gastrula
retribuutiottani -- retribuutio
pesänjakajaksesi -- pesänjakaja
epistemologioillamme -- epistemologia
velkataakoiltani -- velkataakka
mississippiläisilläsi -- mississippiläinen
lapiolliseemme -- lapiollinen
flubendatsoleittanne -- flubendatsoli
keskikasvuissasi -- keskikasvu
vanhoillansa -- vanha
poliisineuvoksiensa -- poliisineuvos
siankärsäkäärmeellään -- siankärsäkäärme
korvansuojuksistaan -- korvansuojus
veriyskökselläsi -- veriyskös
meklaritointansa -- meklaritoimi
lähestymisväylästään -- lähestymisväylä
bussilliselleni -- bussillinen
metsänjalostuksianne -- metsänjalostus
valuutansäännöstelyistäsi -- valuutansäännöstely
hiertimeksemme -- hierrin
menettämisiini -- menettäminen
puolukkapuurottaan -- puolukkapuuro
museoneuvoksillamme -- museoneuvos
narodnikkeinaan -- narodnikki
amoksekaiineinamme -- amoksekaiini
divertikkeleittemme -- divertikkeli
amalgamoinniltani -- amalgamointi
humiinistani -- humiini
ansaitsemisillensa -- ansaitseminen
liikuntapalveluttanne -- liikuntapalvelu
tratsedonejani -- tratsedoni
luistelusuksiansa -- luistelusuksi
konsistorioissasi -- konsistorio
paikoillaanoloissasi -- paikoillaanolo
lettosoiltasi -- lettosuo
siniketuissanne -- sinikettu
kaksituhattaluvuissaan -- kaksituhattaluku
pimeällään -- pimeä
vierailukäynneissänne -- vierailukäynti
affiksiamme -- affiksi
kannanmuutostani -- kannanmuutos
rabulismittasi -- rabulismi
vaunuhevosiksenne -- vaunuhevonen
pahasuisuuksittamme -- pahasuisuus
pitkähöyliltänne -- pitkähöylä
epoksianne -- epoksi
terminologiattanne -- terminologia
kärrypolkujaan -- kärrypolku
pääomistajani -- pääomistaja
keskipilareittensa -- keskipilari
ilotulituksellenne -- ilotulitus
pöytäpakkauksellesi -- pöytäpakkaus
kikkailussani -- kikkailu
luomiemme -- luoma
kiinnitysvel’akseen -- kiinnitysvelka
talviuninasi -- talviuni
rangaistuslyönneiltänsä -- rangaistuslyönti
sisäänostohinnastasi -- sisäänostohinta
roksitromysiinillään -- roksitromysiini
pimennysverhoistansa -- pimennysverho
yleisömuuriemme -- yleisömuuri
lomarakentamistamme -- lomarakentaminen
introspektiivisuudeksemme -- introspektiivisuus
vatsahaavassasi -- vatsahaava
kierrekansioiltansa -- kierrekansio
puujal’allani -- puujalka
fotokoagulaatioitansa -- fotokoagulaatio
hyttiemäntällämme -- hyttiemäntä
itäsuomalaisuuksiltanne -- itäsuomalaisuus
ortopneallasi -- ortopnea
koiranpuremittasi -- koiranpurema
verteporfiineitänsä -- verteporfiini
ostjakkisamojediinne -- ostjakkisamojedi
liimapinnastaan -- liimapinta
eskimokanoottiisi -- eskimokanootti
etätietomme -- etätieto
suopapuillamme -- suopapuu
puolustuskirjoitustanne -- puolustuskirjoitus
saksinousujasi -- saksinousu
keuhkolaskimoittansa -- keuhkolaskimo
syytevaatimuksellamme -- syytevaatimus
matkijoissasi -- matkija
munarakkuloihini -- munarakkula
biolaseinansa -- biolasi
natriumortofenyylifenolistaan -- natriumortofenyylifenoli
laskettelurinteittäsi -- laskettelurinne
pyrylumettani -- pyrylumi
jyskinälläsi -- jyskinä
holvauksestani -- holvaus
puukenkätansseistani -- puukenkätanssi
kolmiomittaustorniensa -- kolmiomittaustorni
tuhoamisinansa -- tuhoaminen
valotiheyksittäni -- valotiheys
heiniensäilytyskeoiltanne -- heiniensäilytyskeko
sädelomiksemme -- sädeloma
lokarillesi -- lokari
alilämpöisyyksillänsä -- alilämpöisyys
arkeokorteksistaan -- arkeokorteksi
koostesanoiltansa -- koostesana
tellurideistaan -- telluridi
sanomalehtikatsaustasi -- sanomalehtikatsaus
kadmiumeistansa -- kadmium
keravalaisemme -- keravalainen
paranirvanallansa -- paranirvana
lehtihaastatteluusi -- lehtihaastattelu
klooritrifluorideinamme -- klooritrifluoridi
treemoriksesi -- treemori
aleponmännyilleen -- aleponmänty
galleillansa -- galli
sentrifuginamme -- sentrifugi
tarvearvioihimme -- tarvearvio
koltaaneillemme -- koltaani
mätänemistilanaan -- mätänemistila
juottovasikkamme -- juottovasikka
sokeroitumisiesi -- sokeroituminen
kroolaajallensa -- kroolaaja
kruunukyyh´yittänsä -- kruunukyyhky
reppureidemme -- reppuri
kansanpuolueitanne -- kansanpuolue
edelfosiineittani -- edelfosiini
lääkeannostelijakseen -- lääkeannostelija
työllisyyskokeiluistani -- työllisyyskokeilu
palopurjeittamme -- palopurje
musertamistamme -- musertaminen
katsomalleni -- katsoma
ryhmäkanneistanne -- ryhmäkanne
tehdashuoneistoiltansa -- tehdashuoneisto
hermotulehduksissansa -- hermotulehdus
lahkokseen -- lahko
bibliomaanienne -- bibliomaani
kastetilaisuuksillamme -- kastetilaisuus
staakeillani -- staaki
soopelinnah'allaan -- soopelinnahka
kenttähyyppienne -- kenttähyyppä
siirituulittansa -- siirituuli
korreloimisissamme -- korreloiminen
kärkikeiloilleni -- kärkikeila
seiloreilleen -- seilori
oheislajilleni -- oheislaji
huvittuneisuudeksesi -- huvittuneisuus
gigantismuksinanne -- gigantismus
tietokonelaukuistanne -- tietokonelaukku
keskuspankkirahoiltaan -- keskuspankkiraha
rivisotilaaseesi -- rivisotilas
rihmastoistanne -- rihmasto
törrötyksiltäsi -- törrötys
lisäväreillään -- lisäväri
apalsilliininanne -- apalsilliini
risedronihapoltanne -- risedronihappo
bonamiooseiltaan -- bonamioosi
tuffiittillemme -- tuffiitti
sävelasteellenne -- sävelaste
viilanpuruissaan -- viilanpuru
hematokriitistani -- hematokriitti
sirrakuskeiltamme -- sirrakuski
afrikankääpiöhaukakseen -- afrikankääpiöhaukka
sotilasurassaan -- sotilasura
alijahittani -- alijah
butamoksaaneillemme -- butamoksaani
kieltolauseissasi -- kieltolause
henkikirjoittajistanne -- henkikirjoittaja
kämmenpuoliamme -- kämmenpuoli
arsenikkiryhmänämme -- arsenikkiryhmä
mädäntyneisyyksillään -- mädäntyneisyys
sitruunanapsijoillamme -- sitruunanapsija
onnellisuustutkijamme -- onnellisuustutkija
narttanani -- nartta
sivuverhoissani -- sivuverho
varpaanväleihini -- varpaanväli
balkaninnäsiöillenne -- balkaninnäsiä
pohjoiskorealaistasi -- pohjoiskorealainen
synergisteillämme -- synergisti
magneettikiisuaan -- magneettikiisu
päiväeläimeltämme -- päiväeläin
käytäväämme -- käytävä
kaveruuksiasi -- kaveruus
aavikkopaksujal′altaan -- aavikkopaksujalka
koetteluidensa -- koettelu
valistuskampanjaltamme -- valistuskampanja
veikkailulleen -- veikkailu
elektronidiffraktiostansa -- elektronidiffraktio
lennostossansa -- lennosto
ruunittansa -- ruuna
höyhenheinittäni -- höyhenheinä
ketjuompeleittanne -- ketjuommel
pääkonsulaateilleen -- pääkonsulaatti
tilinte’oittasi -- tilinteko 
autismillani -- autismi
kieroselkäisyyksillenne -- kieroselkäisyys
valtahahmojeni -- valtahahmo
tilinte'ostaan -- tilinteko
onnellisuuksiltaan -- onnellisuus
räkäni -- räkä
vitaaliparametrittansa -- vitaaliparametri
kantaoreikseni -- kantaori
puolustusmenoittani -- puolustusmenot
pikinahkureissanne -- pikinahkuri
gonioskopiaansa -- gonioskopia
cardiganissaan -- cardigan
luuopeiltansa -- luuoppi
harhaluodillemme -- harhaluoti
uunilohittansa -- uunilohi
tyrotropiiniini -- tyrotropiini
painonmenetyksenäni -- painonmenetys
genreiltäsi -- genre
rikkirouskuistanne -- rikkirousku
teuraspenkkiemme -- teuraspenkki
ennätyssatonne -- ennätyssato
kämppiksettään -- kämppis
kofeinismistani -- kofeinismi
päivikiksemme -- päivikki
intersekseilläni -- interseksi
esivaaleinaan -- esivaali
heittopeleihimme -- heittopeli
jameihimme -- jam
yönä'öksenne -- yönäkö
käväisykseen -- käväisy
tappiollisuuksittasi -- tappiollisuus
sähkövoimalaitoksissanne -- sähkövoimalaitos
pöyristymisessämme -- pöyristyminen
pihvilihaani -- pihviliha
perunavesiltämme -- perunavesi
mökkeilyjämme -- mökkeily
rankingiimme -- ranking
saksalaiseeni -- saksalainen
erovuoroonsa -- erovuoro
tritanomalioistamme -- tritanomalia
hokaneiltansa -- hokan
ymmärtämyksesi -- ymmärtämys
anioninvaihtajoittemme -- anioninvaihtaja
korvaläpiämme -- korvaläpät
avovaunuittanne -- avovaunu
altaasi -- allas
thessalonikalaisettansa -- thessalonikalainen
homofoneinanne -- homofoni
myrskyliitäjänämme -- myrskyliitäjä
fluorihoitoonsa -- fluorihoito
varastomyymälöissänsä -- varastomyymälä
turvavarastoiltasi -- turvavarasto
naakalleni -- naakka
avainkimputtasi -- avainkimppu
poikuuksistansa -- poikuus
vilunkeihinne -- vilunki
sivupainoissanne -- sivupaino
nuorekkuuksissaan -- nuorekkuus
demilitarisoinniltanne -- demilitarisointi
päärynäripsiäisenne -- päärynäripsiäinen
eteläpuolettanne -- eteläpuoli
lapinrouskuunne -- lapinrousku
symboloimisettäni -- symboloiminen
tuulenhaltijastansa -- tuulenhaltija
karsintakilpailuinaan -- karsintakilpailu
songhaittamme -- songhai
tildestänne -- tilde
ceyloniiteistani -- ceyloniitti
beetahydroksibutaanihappoasi -- beetahydroksibutaanihappo
kaaputuksienne -- kaaputus
nikamanasi -- nikama
etelänaapurittamme -- etelänaapuri
tietokoneohjelmoinnissasi -- tietokoneohjelmointi
satamasulullemme -- satamasulku
puhelinliikenteeseesi -- puhelinliikenne
ohjelmistoympäristöltänne -- ohjelmistoympäristö
draamallisuuksittansa -- draamallisuus
kestoväreistänne -- kestoväri
pistelinoittansa -- pistelinko
gasyklidiiniksemme -- gasyklidiini
deferoksamiinittansa -- deferoksamiini
bentatsepaamiensa -- bentatsepaami
dimetyylipolysiloksaaneiksenne -- dimetyylipolysiloksaani
thalassokratialtansa -- thalassokratia
yhteysjuoksuhaudoiltaan -- yhteysjuoksuhauta
sikuniltaan -- sikuna
sillanmurtojaan -- sillanmurto
henkilötietolomakkeidemme -- henkilötietolomake
evästyskeskusteluumme -- evästyskeskustelu
persoonallisuutenanne -- persoonallisuus
diggaamisissasi -- diggaaminen
nahkahoususi -- nahkahousut
tarttumisrefleksittanne -- tarttumisrefleksi
montessorikouluistamme -- montessorikoulu
masiksiltasi -- masis
seksityöntekijästänsä -- seksityöntekijä
estoaineellansa -- estoaine
kuppauksettani -- kuppaus
käsittelypalveluittansa -- käsittelypalvelu
tallallanne -- talla
pikanttisuuksiksesi -- pikanttisuus
totteluillenne -- tottelu
sivettikissallanne -- sivettikissa
virkkuittamme -- virkkuu
laiminansa -- laimi
länsisaksalaisettansa -- länsisaksalainen
tunturikuruillenne -- tunturikuru
marskiltaan -- marski
isoilta‐maksa‐ruohoiltamme -- isomaksaruoho
temelastiinistanne -- temelastiini
ilmatyynyttäni -- ilmatyyny
pyhäkoulujeni -- pyhäkoulu
kuoroteoksenani -- kuoroteos
borosilikaattilaseiltansa -- borosilikaattilasi
sormenjälkilukijoiksensa -- sormenjälkilukija
konstruoijoillemme -- konstruoija
lukuhaluillenne -- lukuhalu
nuhteestasi -- nuhde
nokikanaparviksensa -- nokikanaparvi
suoilvekseksenne -- suoilves
liikuntatoiminaan -- liikuntatoimi
rettelöömme -- rettelö
hiirenpyytäjiksensä -- hiirenpyytäjä
alkuroniumeinansa -- alkuronium
myrkytyksiltänsä -- myrkytys
syrjimisellesi -- syrjiminen
rakletissamme -- rakletti
huumausaineettanne -- huumausaine
filmikaupunkeiksenne -- filmikaupunki
konsulaattiemme -- konsulaatti
ibopamiinissanne -- ibopamiini
kirjakaapeillansa -- kirjakaappi
sulfavalmisteeseemme -- sulfavalmiste
sivukirjastoltasi -- sivukirjasto
tolonidiinilleni -- tolonidiini
sijoituskohteitansa -- sijoituskohde
mainitsijattanne -- mainitsija
suprematisteillani -- suprematisti
seborreoillemme -- seborrea
ortomyksoviruksestamme -- ortomyksovirus
kysyttävinänne -- kysyttävä
nykytilanneinamme -- nykytilanne
maksuvelvollisuudellamme -- maksuvelvollisuus
vastasyntyneettäsi -- vastasyntynyt
luonnonmullistuksellansa -- luonnonmullistus
botswanalaisiesi -- botswanalainen
sydeemeillesi -- sydeemi
liitelyllenne -- liitely
luomiemme -- luomi
himoihini -- himo
barytoneissanne -- barytoni
tenosyklidiineittänne -- tenosyklidiini
klemastiinissani -- klemastiini
terveydenhoitoomme -- terveydenhoito
satukaseteiltani -- satukasetti
kuvapuolittamme -- kuvapuoli
uimahallinasi -- uimahalli
ekskosekantteiksensa -- ekskosekantti
kvartaanakuumeissansa -- kvartaanakuume
basisteistanne -- basisti
haukkanamme -- haukka
angikoinanne -- angika
ahvenanmaalaisilleni -- ahvenanmaalainen
apinanamme -- apina
johtoteloissamme -- johtotela
lamppuharjastani -- lamppuharja
ilmiliekeilleen -- ilmiliekki
joukkoruokailunani -- joukkoruokailu
rasvamaalistani -- rasvamaali
veräjäpuiksenne -- veräjäpuu
evolutiikallensa -- evolutiikka
linnakundeillansa -- linnakundi
kangastateistansa -- kangastatti
tioproniiniimme -- tioproniini
jalkajousiksenne -- jalkajousi
saaristoisistaan -- saaristoinen
punamyssykutojittamme -- punamyssykutoja
kryomagneeteillesi -- kryomagneetti
rynnistämisiimme -- rynnistäminen
miljoonatuellasi -- miljoonatuki
hevosliikkeenänsä -- hevosliike
desjatiinassanne -- desjatiina
pianokouluittamme -- pianokoulu
jaardilinjastanne -- jaardilinja
desorientaatioilleni -- desorientaatio
vakinaisuuteesi -- vakinaisuus
vannonnastamme -- vannonta
haittamikrobiaan -- haittamikrobi
slovakialaisestani -- slovakialainen
palonsammutuksestanne -- palonsammutus
tahitinkalastajinasi -- tahitinkalastaja
vatsatautejanne -- vatsatauti
huveillenne -- hupi
sinivihvilällesi -- sinivihvilä
rahanlähteitämme -- rahanlähde
eteläkarjalaisiltansa -- eteläkarjalainen
taidepapereinamme -- taidepaperi
seuraajakunnissani -- seuraajakunta
deksketoprofeenillanne -- deksketoprofeeni
puolauksellemme -- puolaus
endoftalmiittittani -- endoftalmiitti
kärkiänsä -- kärki
keskikhmerillänne -- keskikhmer
diatomiiteittamme -- diatomiitti
satunnaisuuksiasi -- satunnaisuus
kengurukepilläni -- kengurukeppi
subdekaaneittanne -- subdekaani
pianonsoitonopettajiensa -- pianonsoitonopettaja
otoliitistanne -- otoliitti
kuolettamisiltamme -- kuolettaminen
sananlopuittaan -- sananloppu
diarseenipentaoksidillansa -- diarseenipentaoksidi
menarkeittansa -- menarke
äänikirjoiksemme -- äänikirja
lyijykkeellesi -- lyijyke
kanadanhanhissaan -- kanadanhanhi
rommejansa -- rommi
lykkäilysi -- lykkäily
fonteistaan -- fontti
propenidatsoliltani -- propenidatsoli
kiinnitysvel´oittaan -- kiinnitysvelka
havaintojaksottani -- havaintojakso
onnenkeksinänsä -- onnenkeksi
käänteiskotangenteillani -- käänteiskotangentti
sekretaasistani -- sekretaasi
nuijijoittansa -- nuijija
kädenliikkeenne -- kädenliike
lämmitysuuneillemme -- lämmitysuuni
lohivuokiesi -- lohivuoka
vahanukkeinanne -- vahanukke
syötönpalautuksistasi -- syötönpalautus
glukametasiinistani -- glukametasiini
satuttamiseltasi -- satuttaminen
ajotekniikaltanne -- ajotekniikka
agrologioittanne -- agrologia
ajoviimassansa -- ajoviima
hedelmänviljelijöihinne -- hedelmänviljelijä
lisääntymiselimekseen -- lisääntymiselin
suomalaissiirtolaisittasi -- suomalaissiirtolainen
hypotoonisuuksinasi -- hypotoonisuus
suihkualuksissani -- suihkualus
kellonavaimistanne -- kellonavain
näyttelyäni -- näyttely
näpiltäsi -- näppi
tiilivasaraasi -- tiilivasara
juomapulloinasi -- juomapullo
perinteellisyyksienne -- perinteellisyys
vahatulppaani -- vahatulppa
arviohinnoillamme -- arviohinta
särkkiemme -- särkkä
bambupalmuiltanne -- bambupalmu
rankkurisi -- rankkuri
kaateellemme -- kaade
tietoliikennesatelliiteiksemme -- tietoliikennesatelliitti
hekumointilleni -- hekumointi
asetyyliklorideilleen -- asetyylikloridi
ipronidatsolimme -- ipronidatsoli
hurmeitteni -- hurme
valitusvirtenänne -- valitusvirsi
tähkäliljakasvieihimme -- tähkäliljakasvit
kuljetushihnalleen -- kuljetushihna
sokkeloihisi -- sokkelo
sekapuustoksemme -- sekapuusto
kyläyhdyskuntiemme -- kyläyhdyskunta
sinivatukoittanne -- sinivatukka
ryntäämisistäsi -- ryntääminen
mesipuukasvieinasi -- mesipuukasvit
brasiliankärpästänsä -- brasiliankärppä
porkkananpunaisiksesi -- porkkananpunainen
matkaväsymyksekseen -- matkaväsymys
lankanauhurillaan -- lankanauhuri
haltijavelkakirjoittanne -- haltijavelkakirja
äännähtämisillesi -- äännähtäminen
rämäkkältämme -- rämäkkä
lumijäidensä -- lumijää
ruskealaiseksensa -- ruskealainen
trinitaarisuuksistasi -- trinitaarisuus
kuuhulluanne -- kuuhullu
tietokonekieliltäni -- tietokonekieli
haistattamisissaan -- haistattaminen
öljypohattojansa -- öljypohatta
manoillamme -- mana
lepänlehdellään -- lepänlehti
herttakuninkaaltansa -- herttakuningas
nötköteilleen -- nötkötti
kenttälinnoituksiinsa -- kenttälinnoitus
joulutunnelmillansa -- joulutunnelma
propellihatuittansa -- propellihattu
kuolinvuosittasi -- kuolinvuosi
salmiakkimakeisistansa -- salmiakkimakeinen
fulvestranteiltansa -- fulvestrantti
hikitahrojensa -- hikitahra
suippopäänään -- suippopää
aatesuunnakseen -- aatesuunta
pähkinähiirillänsä -- pähkinähiiri
taisteluainesuojeluillesi -- taisteluainesuojelu
moonbootsieikseen -- moonbootsit
avustusoperaatioiksensa -- avustusoperaatio
koiranleukaani -- koiranleuka
tulomatkoittanne -- tulomatka
kohteluittesi -- kohtelu
erotteluksesi -- erottelu
mallipiirustuksellesi -- mallipiirustus
mustahauillansa -- mustahauki
täpäryydettäsi -- täpäryys
sykloplegiamme -- sykloplegia
pyörölleni -- pyörö
täkänänänsä -- täkänä
peitinhöyhenilläni -- peitinhöyhen
ratsastusasendoittansa -- ratsastusasento
diktaaleittaan -- diktaali
jumbosijoissaan -- jumbosija
savakkomurteenanne -- savakkomurre
kyöpelissänsä -- kyöpeli
oseanografiassansa -- oseanografia
susikoiriani -- susikoira
ksenylamiiniaan -- ksenylamiini
kolhoosijärjestelmillänsä -- kolhoosijärjestelmä
hankaluuksillani -- hankaluus
alkuperäistilojasi -- alkuperäistila
turvavyöpakoiltani -- turvavyöpakko
liiketalottani -- liiketalo
curieidensa -- curie
tietoniekkoillansa -- tietoniekka
karbamaatiksesi -- karbamaatti
yksityisautoiluittenne -- yksityisautoilu
naniitillesi -- naniitti
apperseptioitamme -- apperseptio
pulisonkeihini -- pulisonki
kaksoissotilaitanne -- kaksoissotilas
viljakauppojansa -- viljakauppa
kitupiikiksensa -- kitupiikki
suunnittelupöytiinne -- suunnittelupöytä
valintajalostuksellani -- valintajalostus
jäljittimelläsi -- jäljitin
navakkuuteeni -- navakkuus
ammattioppilaslautakunnastani -- ammattioppilaslautakunta
vapahtajissasi -- vapahtaja
palkinnonsaajastansa -- palkinnonsaaja
raamatunlauseessaan -- raamatunlause
penispumpuistanne -- penispumppu
ylioppilaskokeestaan -- ylioppilaskoe
kiusanteollansa -- kiusanteko
ikäjakaumikseen -- ikäjakauma
kapulakielettään -- kapulakieli
koulutodistuksestanne -- koulutodistus
etäkäyttäjäni -- etäkäyttäjä
mielipiteidenvaihtonasi -- mielipiteidenvaihto
murjuistansa -- murju
kotikaupungeillaan -- kotikaupunki
jännitteeltänne -- jännite
mannermaastani -- mannermaa
minkkitarhaajananne -- minkkitarhaaja
painamisluvastaan -- painamislupa
ikätovereissani -- ikätoveri
marsalkkuudettamme -- marsalkkuus
punasteluttaan -- punastelu
vatruskoillenne -- vatruska
ryhelmiänne -- ryhelmä
egoistisuuksiansa -- egoistisuus
puunkäytölläni -- puunkäyttö
suosittelijassasi -- suosittelija
pyökkilehtorouskullensa -- pyökkilehtorousku
taskuheiniltäni -- taskuheinä
bataaninkuhankeittäjättäni -- bataaninkuhankeittäjä
rankkureiltani -- rankkuri
kirjausmiehestään -- kirjausmies
laittelemisettaan -- laitteleminen
lesotholaistasi -- lesotholainen
rokotettuinansa -- rokotettu
illatiivejansa -- illatiivi
bebopillamme -- bebop
sekaantumistani -- sekaantuminen
hiukkassuodatimenne -- hiukkassuodatin
karvaskurkussaan -- karvaskurkku
reilaamisessansa -- reilaaminen
yhdyssubstantiivinaan -- yhdyssubstantiivi
polarisoitumistesi -- polarisoituminen
laivahuoltajanansa -- laivahuoltaja
etambutolinamme -- etambutoli
itsetarkoituksinamme -- itsetarkoitus
nilkkaremmikengässämme -- nilkkaremmikenkä
lykkäyksillenne -- lykkäys
pelitaktiikallaan -- pelitaktiikka
susianeillenne -- susian
patapölkkyinämme -- patapölkky
sauhuamisistasi -- sauhuaminen
osastosihteereitani -- osastosihteeri
suolenmutkikseen -- suolenmutka
punktiollenne -- punktio
kitkeröittäsi -- kitkerö
ruokaöljyyni -- ruokaöljy
äpylipaillaan -- äpylipai
nukkapintanaan -- nukkapinta
lähituntumattanne -- lähituntuma
saivareinasi -- saivare
trimetyylisilyylieetteriliuokseksesi -- trimetyylisilyylieetteriliuos
yhteystiedoikseni -- yhteystieto
pyökkiseitikkeillensä -- pyökkiseitikki
lahjapakkaustanne -- lahjapakkaus
laventelieni -- laventeli
integraalitestillani -- integraalitesti
vierintäjyrsimenään -- vierintäjyrsin
kaasuvipunaan -- kaasuvipu
kuitusuuntistansa -- kuitusuunta
ajokyylleni -- ajokyky
eläinmaailmattanne -- eläinmaailma
autopeileillänne -- autopeili
sieraimeenne -- sierain
avokkejani -- avokki
tutkimusresursseistani -- tutkimusresurssi
rämeelläni -- räme
luotokirvisenne -- luotokirvinen
henkivakuutusyhtiönään -- henkivakuutusyhtiö
akariaasinaan -- akariaasi
talousvyöhykkeisiimme -- talousvyöhyke
erikoissäännöillään -- erikoissääntö
hyönteisparvianne -- hyönteisparvi
yliaikaisuuksiltansa -- yliaikaisuus
oppilasmatrikkelillamme -- oppilasmatrikkeli
tuulimyrs´yistäni -- tuulimyrsky
parturoinneiltanne -- parturointi
majoitusliikkeessämme -- majoitusliike
iskuhaavoiltansa -- iskuhaava
lojaalisuuksiltanne -- lojaalisuus
haarakkeittanne -- haarake
yhteisösakottamme -- yhteisösakko
kärkisolukoittansa -- kärkisolukko
valveiltani -- valve
twistaustasi -- twistaus
rotuoppiensa -- rotuoppi
kiitäjälintunsa -- kiitäjälintu
sekovartenanne -- sekovarsi
maustefenkoleinamme -- maustefenkoli
kielisuudelmiltani -- kielisuudelma
hypoteesiansa -- hypoteesi
keikyäläisillämme -- keikyäläinen
ansiofunktioinamme -- ansiofunktio
konetyömiehellemme -- konetyömies
pahoittelujaan -- pahoittelu
palautumisiinne -- palautuminen
brodimopriimeiksensa -- brodimopriimi
täpläharmomittareittenne -- täpläharmomittari
luutarhattansa -- luutarha
kuljetusmuotoinani -- kuljetusmuoto
etyylikloridikseen -- etyylikloridi
siitakesienettänsä -- siitakesieni
ykkösoluihisi -- ykkösolut
säveltämisistään -- säveltäminen
majavannahkanani -- majavannahka
peitelevyiksemme -- peitelevy
lähtötasokseni -- lähtötaso
kauppakouluistani -- kauppakoulu
ballerinanaan -- ballerina
kasvispadoissamme -- kasvispata
kalsiumtartraatteiksensa -- kalsiumtartraatti
pikkolohuilujeni -- pikkolohuilu
esinetulostukseksemme -- esinetulostus
ajautumisiltamme -- ajautuminen
triviaalikouluttanne -- triviaalikoulu
konservatiiveillamme -- konservatiivi
äheltämiseeni -- äheltäminen
pituusmerkistäni -- pituusmerkki
meksikolaisuuksiksenne -- meksikolaisuus
vuorokausimaksuksesi -- vuorokausimaksu
tarpeenanne -- tarve
melskaksemme -- melska
keularuumillenne -- keularuuma
granadillastaan -- granadilla
lamppukoteloitansa -- lamppukotelo
kuljeksinnoissansa -- kuljeksinta
fotobombauksenanne -- fotobombaus
aineopintojensa -- aineopinnot
estelyideni -- estely
vetysyanidistaan -- vetysyanidi
leimukukattansa -- leimukukka
siirtonurmikkoonsa -- siirtonurmikko
sytotoksiinilääkettänsä -- sytotoksiinilääke
virhepainamani -- virhepainama
minttujäätelöitteni -- minttujäätelö
rakoseinättänsä -- rakoseinä
kerrottavinaan -- kerrottava
kotokoissansa -- kotoko
tippaleivällesi -- tippaleipä
argipressiineinanne -- argipressiini
omnivoristamme -- omnivori
takistoskooppiini -- takistoskooppi
lystereihini -- lysteri
aasiantupsuhäntäpiikkisi'astani -- aasiantupsuhäntäpiikkisika
pitäjäruo′ikseen -- pitäjäruoka
tetrakosanolittamme -- tetrakosanoli
ydinfysiikoihisi -- ydinfysiikka
kanadanranskoissasi -- kanadanranska
urheilupäiväksemme -- urheilupäivä
aasianrääkkiäisiesi -- aasianrääkkiäinen
läpikävelyissäni -- läpikävely
kartesiolaisillanne -- kartesiolainen
hälinöiltänsä -- hälinä
idoliamme -- idoli
variogrammeillasi -- variogrammi
vesiskorpioniensa -- vesiskorpioni
iskusarjoillenne -- iskusarja
kukkopojiksemme -- kukkopoika
elämänmyönteisyyksiänne -- elämänmyönteisyys
fasaanikukoltaan -- fasaanikukko
vahingoittumaanne -- vahingoittuma
lukutaidoistasi -- lukutaito
angulaatioissamme -- angulaatio
katselmustoimituksinasi -- katselmustoimitus
teekkarihuumorejanne -- teekkarihuumori
karkkilalaisellani -- karkkilalainen
dalmatiojani -- dalmatia
kryptandeillansa -- kryptandi
helppolukuisuuksistaan -- helppolukuisuus
juurikäävissänne -- juurikääpä
kisultatsiinikseni -- kisultatsiini
orkesterisovituksettanne -- orkesterisovitus
miniatyyrimaalariksenne -- miniatyyrimaalari
protiokarbihydrokloridianne -- protiokarbihydrokloridi
etujousettamme -- etujousi
tekstiilisuunnittelijoittasi -- tekstiilisuunnittelija
muskatellejansa -- muskatelli
raakilemaisuudeltanne -- raakilemaisuus
opistoasteeseensa -- opistoaste
kaatolavoihimme -- kaatolava
pyhitettyni -- pyhitetty
propiolaktoneiltansa -- propiolaktoni
siperiankurppiinsa -- siperiankurppa
edesvastuullisuuksittansa -- edesvastuullisuus
suosypresseillenne -- suosypressi
directoreittamme -- director
dekameerisi -- dekameeri
puitela’eittanne -- puitelaki
jatkuvuuksistansa -- jatkuvuus
kaatajassani -- kaataja
kiinteistölainattamme -- kiinteistölaina
laaksolaisittamme -- laaksolainen
parodiallensa -- parodia
ruoskanjälkiini -- ruoskanjälki
polyisobuteenini -- polyisobuteeni
munuaisinsuffisienssejanne -- munuaisinsuffisienssi
nurjahtamisistanne -- nurjahtaminen
pakastuskelmuissamme -- pakastuskelmu
valusangoiksesi -- valusanko
aaltoputkenansa -- aaltoputki
brokrinaatilleen -- brokrinaatti
pikkuvasikoistani -- pikkuvasikka
amatsonejaan -- amatsoni
synnytysvaurioillansa -- synnytysvaurio
rotsiini -- rotsi
pahante'oistamme -- pahanteko
valkotupakoiltani -- valkotupakka
henkseliensä -- henkseli
ajojahtiini -- ajojahti
seitosestanne -- seitonen
lorvitaudeillansa -- lorvitauti
salamyhkäisyyksillensä -- salamyhkäisyys
kaarifriisissanne -- kaarifriisi
urituksenaan -- uritus
silmähaudekupillamme -- silmähaudekuppi
kazakstanilaisiimme -- kazakstanilainen
osuusliikkeiltanne -- osuusliike
bratwurstianne -- bratwursti
diskotanssillanne -- diskotanssi
variksenmarjaasi -- variksenmarja
hirvikärpäsillänsä -- hirvikärpänen
vesikäymäläksesi -- vesikäymälä
hevoskuiskaajaasi -- hevoskuiskaaja
trastutsumabiamme -- trastutsumabi
konetöitänne -- konetyö
keiriöiltään -- keiriöt
joukkotappelussasi -- joukkotappelu
rumbaamattansa -- rumbata
urapaikkausteni -- urapaikkaus
lattialastoillasi -- lattialasta
sanarajojasi -- sanaraja
suojaliivistänne -- suojaliivi
loimuissanne -- loimu
kirkossakävijättärestäsi -- kirkossakävijätär
rakennusjärjestyksittään -- rakennusjärjestys
seurakuntamestarillensa -- seurakuntamestari
liaaneittani -- liaani
psykoottisuudestamme -- psykoottisuus
kvartsikiteiltänsä -- kvartsikide
aasiantrogonissani -- aasiantrogoni
yliskamareillamme -- yliskamari
maalijauhettani -- maalijauhe
merisairaudellesi -- merisairaus
repolarisaatioittaan -- repolarisaatio
juuripermanenttieni -- juuripermanentti
ruskomakiksensa -- ruskomaki
rainaamanansa -- rainata
käsiteollisuutenanne -- käsiteollisuus
astelevyjäni -- astelevy
buffet'ssanne -- buffet
virmajuurikasveinanne -- virmajuurikasvi
silottamisellensa -- silottaminen
raskaudenkeskeytysaineitaan -- raskaudenkeskeytysaine
maisemoinneistamme -- maisemointi
lunttauksiisi -- lunttaus
regissööriinsä -- regissööri
roskaruoallaan -- roskaruoka
renkaanheitoiksemme -- renkaanheitto
mäntäventtiilejäni -- mäntäventtiili
kainihappoinaan -- kainihappo
sadasosiltamme -- sadasosa
öljykuljetuksikseni -- öljykuljetus
densimetrejänne -- densimetri
siteitään -- side
susipuunansa -- susipuu
juomarahaanne -- juomaraha
päästäisellään -- päästäinen
kansanpuistoistasi -- kansanpuisto
vagotoniastanne -- vagotonia
naisääniksenne -- naisääni
kadottamisessamme -- kadottaminen
salpingiittiinsa -- salpingiitti
kasvisoluasi -- kasvisolu
hondurasilaisistaan -- hondurasilainen
apulaispääministereittenne -- apulaispääministeri
elämänläheisyyksiimme -- elämänläheisyys
eteläsudanilaiseltamme -- eteläsudanilainen
hedelmämarmeladiltansa -- hedelmämarmeladi
rensselillänne -- rensseli
räjähdyksenämme -- räjähdys
milnasipraaneiksesi -- milnasipraani
sapelihammastiikerieni -- sapelihammastiikeri
vanukkaastasi -- vanukas
nykyvaiheellesi -- nykyvaihe
olympiakomiteamme -- olympiakomitea
työlupienne -- työlupa
tabloidiko’ossaan -- tabloidikoko
uuniruokananne -- uuniruoka
erillisjulkaisuillasi -- erillisjulkaisu
puheenjohtajamaallensa -- puheenjohtajamaa
vaivaisäijänänsä -- vaivaisäijä
jääpallokentistänne -- jääpallokenttä
antofobiojaan -- antofobia
chilenpussirotissaan -- chilenpussirotta
nostalgisointeillansa -- nostalgisointi
tupakkaholkkistamme -- tupakkaholkki
ohilyöntinäsi -- ohilyönti
voihkeitaan -- voihke
imputointiinsa -- imputointi
vietoltansa -- vietto
valeniloillamme -- valenila
alkutaipaleni -- alkutaival
hintavyöryihimme -- hintavyöry
sopimusviljelystänsä -- sopimusviljely
testitauluksenne -- testitaulu
pyykkiään -- pyykki
sodomioikseni -- sodomia
purjelennossani -- purjelento
mielistelyillenne -- mielistely
uveellasi -- uve
lahjateoksellani -- lahjateos
lanteistani -- lanne
stegosauruksienne -- stegosaurus
ruokaresepteinänsä -- ruokaresepti
huuttoreillesi -- huuttori
oomeganasi -- oomega
läpipääsemättömyyksistämme -- läpipääsemättömyys
kojootillenne -- kojootti
sepatsoniumkloridistansa -- sepatsoniumkloridi
lakonmurtajani -- lakonmurtaja
julkaisuvapaudeltaan -- julkaisuvapaus
galangoistani -- galanga
pikamoottoreitani -- pikamoottori
tislaustuotteidemme -- tislaustuote
mujahideenikseen -- mujahideen
geotermioittaan -- geotermia
enokullattamme -- enokulta
suuhaarananne -- suuhaara
kunnallisvalituksiksesi -- kunnallisvalitus
riutumuksestasi -- riutumus
puutottaan -- puutto
paperilaadustansa -- paperilaatu
intianmintullamme -- intianminttu
kutistekalvojensa -- kutistekalvo
maksasairauksinansa -- maksasairaus
ydininsinööreittäni -- ydininsinööri
jäljentämöillämme -- jäljentämö
paklitakseleitasi -- paklitakseli
afrikanrakonokkanaan -- afrikanrakonokka
teilirataisiisi -- teiliratas
limanerityksiltäni -- limaneritys
puhenopeudessansa -- puhenopeus
ketjuteorioistani -- ketjuteoria
pääviemäristämme -- pääviemäri
monivärihaperossaan -- monivärihapero
pastajuotokselleni -- pastajuotos
ympäristöministeriöiksensä -- ympäristöministeriö
kaikujasi -- kaiku
orfeuskertuttaan -- orfeuskerttu
harjoittelurangellamme -- harjoittelurange
utareiksenne -- utareet
viherelenioideni -- viherelenia
helmipuumuurananne -- helmipuumuura
hinduihini -- hindu
mattopytoneissani -- mattopyton
raakametalleidesi -- raakametalli
esivaaleissasi -- esivaali
kukkalaatikoissasi -- kukkalaatikko
spermapankkieni -- spermapankki
tritikalejansa -- tritikali
tuntokasvillasi -- tuntokasvi
maleksintoinansa -- maleksinta
etyleenidiaminissasi -- etyleenidiamini
rokkinsa -- rokki
ristikkokuvioksemme -- ristikkokuvio
sääilmiöinäsi -- sääilmiö
rengasteoriastamme -- rengasteoria
havannasikarinanne -- havannasikari
moottoriveneilynänne -- moottoriveneily
stringiltään -- string
kirjemaksujenne -- kirjemaksu
saraseenilaisistamme -- saraseenilainen
ruostesuojauksettasi -- ruostesuojaus
luopioudeksesi -- luopious
klarinetistillenne -- klarinetisti
kirjesalaisuutenani -- kirjesalaisuus
pietistissäni -- pietisti
kerrannaisvaikutuksissani -- kerrannaisvaikutus
enkefalopatioiltanne -- enkefalopatia
lumevaikutukseltanne -- lumevaikutus
vetoajinasi -- vetoaja
taidevalokuviltamme -- taidevalokuva
liikenneväylillänne -- liikenneväylä
indefiniiteiksenne -- indefiniitti
uveiittiksemme -- uveiitti
pystypitkittäistasoittansa -- pystypitkittäistaso
lillukoillamme -- lillukka
takassanne -- takka
kynttilänjal′aksemme -- kynttilänjalka
agraaripolitiikoittamme -- agraaripolitiikka
kaakeliuuneinaan -- kaakeliuuni
pahapuolukoittasi -- pahapuolukka
zinnwaldiiteissasi -- zinnwaldiitti
käytävälläsi -- käytävä
käärmekuusiinsa -- käärmekuusi
keihäänheittotuloksinaan -- keihäänheittotulos
ryöpsäyksenäsi -- ryöpsäys
tapahtumalokeissamme -- tapahtumaloki
kaksoiskosketusteni -- kaksoiskosketus
atomiabsorptiospektrometriksemme -- atomiabsorptiospektrometri
konjakkikahveissaan -- konjakkikahvi
hiilisangoittanne -- hiilisanko
vapaakiduskotiloidensa -- vapaakiduskotilo
drinkeittämme -- drink
kaupunkitiloillaan -- kaupunkitila
dehydrogenaatiostansa -- dehydrogenaatio
innervaatioidenne -- innervaatio
amidaasiksesi -- amidaasi
kiusaamisinamme -- kiusaaminen
etuhuoneissanne -- etuhuone
suutarinammateissamme -- suutarinammatti
akryylimaalauksinanne -- akryylimaalaus
siviilikohteestansa -- siviilikohde
juutalaiskristittynäni -- juutalaiskristitty
välialueisiisi -- välialue
hartiavoimamme -- hartiavoima
tunneliaukoksemme -- tunneliaukko
hotellivirkailijoittanne -- hotellivirkailija
kokonaishaihduntojensa -- kokonaishaihdunta
irtotaskuksesi -- irtotasku
amerikankuusamallenne -- amerikankuusama
ympäristöseuduiksensa -- ympäristöseutu
kadotuksiltani -- kadotus
hellerajoissasi -- helleraja
harmaapäänapsijastasi -- harmaapäänapsija
iltakilpailuissansa -- iltakilpailu
arominvahventeelleen -- arominvahvenne
suutarintöitäni -- suutarintyö
juomakaudeksensa -- juomakausi
toistoalueilleen -- toistoalue
tuberkuloosirokotuksittaan -- tuberkuloosirokotus
syntyämme -- synty
sammutustenne -- sammutus
tilinte′oltani -- tilinteko
kellertämisiinsä -- kellertäminen
chauvinisteillensa -- chauvinisti
calmetterokotteessaan -- calmetterokote
miestyövoimillani -- miestyövoima
disjunktiivikonjunktiollansa -- disjunktiivikonjunktio
pohjavesikerroksellansa -- pohjavesikerros
piispoiltamme -- piispa
tuiskusäällään -- tuiskusää
käyttelytilinäni -- käyttelytili
kakkusellenne -- kakkunen
kuokaniskuittanne -- kuokanisku
lainastoinansa -- lainasto
kuntopalloillasi -- kuntopallo
ekonometrikossasi -- ekonometrikko
sydänlangoistaan -- sydänlanka
johanneksenleipäpuillamme -- johanneksenleipäpuu
vakseenihapostanne -- vakseenihappo
kirjoituskirjaimellaan -- kirjoituskirjain
saartorenkaittani -- saartorengas
shawneittenne -- shawnee
perikardiittiemme -- perikardiitti
oripääläisikseen -- oripääläinen
magmapesäkkeillensä -- magmapesäke
filosofoijanne -- filosofoija
askelmuutoksenaan -- askelmuutos
alfalinoleenihapoittasi -- alfalinoleenihappo
uhripisteistamme -- uhripiste
talouskriiseiksemme -- talouskriisi
arovyöhykkeidemme -- arovyöhyke
maanviljelystyöstäni -- maanviljelystyö
kasvettumisiksenne -- kasvettuminen
vannomisestani -- vannominen
taidepuistoamme -- taidepuisto
ovaalini -- ovaali
suojakosketinpistotulpillasi -- suojakosketinpistotulppa
tummarusokeikseni -- tummarusokki
amerikkalaismiestäsi -- amerikkalaismies
pystyotteluissani -- pystyottelu
niittokonettamme -- niittokone
asylaatiottaan -- asylaatio
kitkatyöttömyydeltään -- kitkatyöttömyys
saunionoidanlukoiksensa -- saunionoidanlukko
kalkkijauheihimme -- kalkkijauhe
haaraosastoksensa -- haaraosasto
povareillenne -- povari
ambrapuitasi -- ambrapuu
dysfemismeistäni -- dysfemismi
neosomeinansa -- neosomi
aurinkohoidoiltamme -- aurinkohoito
yliopistovir´allansa -- yliopistovirka
revanssissasi -- revanssi
etyylikartritsoaateissasi -- etyylikartritsoaatti
alkuunpanoiltani -- alkuunpano
säästövakuutuksiltamme -- säästövakuutus
markkinavoimissasi -- markkinavoima
tunnussäveliänne -- tunnussävel
kaislakynttilälläni -- kaislakynttilä
takaniityltäsi -- takaniitty
pikkuharmianne -- pikkuharmi
dilemmaksemme -- dilemma
kruununvasallillansa -- kruununvasalli
kuulutuksekseen -- kuulutus
ulkolaudoituksillaan -- ulkolaudoitus
sotilaslaitoksianne -- sotilaslaitos
lassokseni -- lasso
luonnonmenetelmillensä -- luonnonmenetelmä
meritieteeltämme -- meritiede
pölyihini -- pöly
kusetuksiemme -- kusetus
nonsenseissani -- nonsense
kryytimaallaan -- kryytimaa
kalkuttamisestasi -- kalkuttaminen
aktualisoimiseltansa -- aktualisoiminen
hämppyinään -- hämppy
vapautusjärjestöittään -- vapautusjärjestö
kalkkimaariankämmekköihinne -- kalkkimaariankämmekkä
henkivartijallanne -- henkivartija
rintaresonanssistaan -- rintaresonanssi
korottajiltamme -- korottaja
panimomestareistaan -- panimomestari
seliprololittanne -- seliprololi
työvuoroluetteloidemme -- työvuoroluettelo
jalkajousenasi -- jalkajousi
varamiehistänne -- varamies
kouvolalaiseksensa -- kouvolalainen
monosemioihisi -- monosemia
tekokorundilleni -- tekokorundi
tallentajieni -- tallentaja
kaappitarkastuksenasi -- kaappitarkastus
nykyrunouksinaan -- nykyrunous
tirrinämme -- tirri
virallisuuksiemme -- virallisuus
viistopurjeellaan -- viistopurje
pusikkoansa -- pusikko
staretseistansa -- starets
ompelupiiristaan -- ompelupiiri
kynäveitsiltämme -- kynäveitsi
skotlantilaiseenne -- skotlantilainen
tulopolitiikallasi -- tulopolitiikka
sähköpostiviestimme -- sähköpostiviesti
yhdenmuotoisuuskuvauksessaan -- yhdenmuotoisuuskuvaus
kaarisekunnittasi -- kaarisekunti
kiikkastuolistanne -- kiikkastuoli
normaalilämpöisyyksittämme -- normaalilämpöisyys
paleokonservatiivisi -- paleokonservatiivi
rengasalueiltasi -- rengasalue
poltergeisteihini -- poltergeist
erityislaatuisuuksiemme -- erityislaatuisuus
punatiiliyliopistoltasi -- punatiiliyliopisto
hilseilevyydeksensä -- hilseilevyys
pyyhiskelyllenne -- pyyhiskely
ulkovarustukseltanne -- ulkovarustus
tariffointinanne -- tariffointi
mekoproppinasi -- mekoproppi
kissannau´uittanne -- kissannauku
nostolupiansa -- nostolupa
avioehtosopimuksiinne -- avioehtosopimus
typeryydettään -- typeryys
alivoimamaalejasi -- alivoimamaali
louisiadenkukastajissasi -- louisiadenkukastaja
mariposaniinsa -- mariposan
koululaukuistanne -- koululaukku
kanssapelaajiltansa -- kanssapelaaja
atriumtaloillaan -- atriumtalo
asemalaiturittansa -- asemalaituri
herneenvarreksensa -- herneenvarsi
vuoristokasvilleni -- vuoristokasvi
otsonoimisittasi -- otsonoiminen
tahkojuustokseen -- tahkojuusto
pentyyliformiaateiltansa -- pentyyliformiaatti
suojeluksistaan -- suojelus
amerikanpiiskujäniksessämme -- amerikanpiiskujänis
baskimaalaiselleen -- baskimaalainen
vaihtopenkilläsi -- vaihtopenkki
ruukkukasviltanne -- ruukkukasvi
kiillegneisseiltäni -- kiillegneissi
myrskytulvassani -- myrskytulva
siperianangervollasi -- siperianangervo
mäkimiehinään -- mäkimies
kääpiöillämme -- kääpiö
lamellikuljettimiamme -- lamellikuljetin
tiitiäisiämme -- tiitiäinen
kaksoisotteluunsa -- kaksoisottelu
toimitustakauksessani -- toimitustakaus
fonisteiksenne -- fonisti
ekavismutteissani -- ekavismutti
todistelujensa -- todistelu
laskuvarjohypyltäni -- laskuvarjohyppy
piuveiltani -- piuvi
ketoneilikakseen -- ketoneilikka
pikoksitrobiiniisi -- pikoksitrobiini
ersäläisiänsä -- ersäläinen
työjaksoihisi -- työjakso
ankkurinkynnellemme -- ankkurinkynsi
vaateavustuksiksensa -- vaateavustus
trikuspidaaliläpvittänsä -- trikuspidaaliläppä
sotilasaseittamme -- sotilasase
vartiorikoksellamme -- vartiorikos
äiteydeksensä -- äiteys
quislingeillenne -- quisling
koristekuvioissaan -- koristekuvio
kaliumsyanideinamme -- kaliumsyanidi
toipumisettansa -- toipuminen
punatäplärouskuillamme -- punatäplärousku
lapsuudenkokemuksillensa -- lapsuudenkokemus
kivikoristansa -- kivikori
kojoottikoiriansa -- kojoottikoira
kajoittamme -- kajo
rundikopeillansa -- rundikoppi
kuormituskertoimiaan -- kuormituskerroin
tullihuutokaupassaan -- tullihuutokauppa
emäpitäjässämme -- emäpitäjä
tilapäisapuusi -- tilapäisapu
hihittäjälleni -- hihittäjä
jalkapelillenne -- jalkapeli
laskimoillaan -- laskimo
palvelussopimukseltasi -- palvelussopimus
loisteväreilleni -- loisteväri
japaninyrttiputkillansa -- japaninyrttiputki
rahalainanansa -- rahalaina
ruokahuoneihinne -- ruokahuone
atamaaneistasi -- atamaani
veeninämme -- veeni
lameillani -- lamee
bluffaajillansa -- bluffaaja
apteekkarissasi -- apteekkari
taudinmäärityskokeidenne -- taudinmäärityskoe
luistimilleni -- luistin
fontanelleihinne -- fontanelli
ajuriinne -- ajuri
gooneittenne -- gooni
valkoniskakutojaltaan -- valkoniskakutoja
tervaveneiksensa -- tervavene
isovyötiäisessäsi -- isovyötiäinen
muurariuksistani -- muurarius
väestökirjanpidoltani -- väestökirjanpito
kirkkokolehteihini -- kirkkokolehti
opetusteknologioinaan -- opetusteknologia
reikälevyjäsi -- reikälevy
septuageesimiltasi -- septuageesima
kaksiväripainannoittani -- kaksiväripainanta
spagaatistanne -- spagaatti
hylkiöissämme -- hylkiö
taistelulajiksesi -- taistelulaji
kondroitiinisulfaatissanne -- kondroitiinisulfaatti
suurellisuuksikseen -- suurellisuus
naftyylietikkahappoetyyliesteriksesi -- naftyylietikkahappoetyyliesteri
puolukkasi -- puolukka
ainemäärällänne -- ainemäärä
pesäkekovettumatautiaan -- pesäkekovettumatauti
aavesärylläsi -- aavesärky
äänentallennustekniikkaasi -- äänentallennustekniikka
täsmälähetykseksensä -- täsmälähetys
tahranpoistoaineittenne -- tahranpoistoaine
älytelevisiottansa -- älytelevisio
voihkijoinansa -- voihkija
yhdysverbeistänne -- yhdysverbi
esineenäsi -- esine
käyttöpääomiksenne -- käyttöpääoma
kapaloasteitani -- kapaloaste
riisiposliinillanne -- riisiposliini
laboratoriovälineelläni -- laboratorioväline
lohduttomuudellanne -- lohduttomuus
aaltomekaniikoiksenne -- aaltomekaniikka
kruunukävykkikasvieiksemme -- kruunukävykkikasvit
uutiskuvaajinani -- uutiskuvaaja
toimistohotellinaan -- toimistohotelli
fibraatteillesi -- fibraatti
talousteoriattasi -- talousteoria
osastosihteerinasi -- osastosihteeri
kvartiilittansa -- kvartiili
sisariltamme -- sisar
umbrissasi -- umbri
ekstinktiokseiltani -- ekstinktioksi
katselukirjojenne -- katselukirja
rautatievirkamiehiltään -- rautatievirkamies
atolleillasi -- atolli
lausepainoinanne -- lausepaino
aatehistorioiltanne -- aatehistoria
infrapunakameroitaan -- infrapunakamera
maisteriohjelmassani -- maisteriohjelma
avaruusteleskooppeihimme -- avaruusteleskooppi
jalkanuottistasi -- jalkanuotta
pänttäämisistään -- pänttääminen
uutisnenänänsä -- uutisnenä
vertailuryhmältänne -- vertailuryhmä
galicioitani -- galicia
juminne -- jumi
pallokentillämme -- pallokenttä
huiviholkkillasi -- huiviholkki
lennonselvittäjäänne -- lennonselvittäjä
myötäotteeksesi -- myötäote
satulapäisyyksiltäsi -- satulapäisyys
usuttamisiltamme -- usuttaminen
vitriineilleni -- vitriini
varjoyrteillesi -- varjoyrtti
rekyylienergiastamme -- rekyylienergia
ryytijuustoillemme -- ryytijuusto
itsetarkkailuitasi -- itsetarkkailu
koronaareinaan -- koronaari
skitsogonioiltamme -- skitsogonia
alueosastoihinsa -- alueosasto
delekvamiineistamme -- delekvamiini
lippaihinne -- lipas
liikunnanohjaajikseen -- liikunnanohjaaja
ilmaherruuksillani -- ilmaherruus
paremmuudestani -- paremmuus
pentametreistani -- pentametri
predestinaatiossani -- predestinaatio
ääntöväylilläni -- ääntöväylä
martiointejani -- martiointi
haarapyrstönäpsijöillemme -- haarapyrstönäpsijä
kansalaisopistolleen -- kansalaisopisto
kengurottansa -- kengurotat
samovaareistansa -- samovaari
kreosoottejanne -- kreosootti
marraskasviini -- marraskasvi
kukkamaaltamme -- kukkamaa
ohjauskeinoikseen -- ohjauskeino
kalkkeiksensa -- kalke
tuberkuloosirokotustensa -- tuberkuloosirokotus
lamaantumisestani -- lamaantuminen
sakastaan -- sakka
koneistumisittasi -- koneistuminen
taljoikseen -- talja
isoja‑pandojasi -- isopanda
itaalejanne -- itaali
viljelykierrottasi -- viljelykierto
kivääriampujastanne -- kivääriampuja
harmaapäätanssijojani -- harmaapäätanssija
suurilmastoamme -- suurilmasto
sinapinkeltaisittansa -- sinapinkeltainen
voittotuloksellani -- voittotulos
viljelijäväestöiksenne -- viljelijäväestö
kraaviloheeni -- kraavilohi
liuotteitasi -- liuote
pinnakkaiskopiollasi -- pinnakkaiskopio
purppurahohteiltanne -- purppurahohde
värähdyslaajuuksiinne -- värähdyslaajuus
tarkkeittenne -- tarke
tuareginamme -- tuaregi
rukoilevaistensa -- rukoilevainen
aroketuissansa -- arokettu
juolavehnittään -- juolavehnä
törmärannikkoinansa -- törmärannikko
kodikologiallasi -- kodikologia
tulostilastollemme -- tulostilasto
oksiimeillani -- oksiimi
korkeakoulusivistyksenäsi -- korkeakoulusivistys
kulmakorkeudettamme -- kulmakorkeus
kenttäkelpoisuuksiansa -- kenttäkelpoisuus
tryffeleissänne -- tryffeli
uudenkaledonianviheltäjillänne -- uudenkaledonianviheltäjä
piipputupakoideni -- piipputupakka
tankomagneetillamme -- tankomagneetti
sumumerkeissänne -- sumumerkki
viholaiseksensa -- viholainen
fibrinogeenistämme -- fibrinogeeni
poisiltani -- poisi
sivupersoonittani -- sivupersoona
nutani -- nuta
vektorialgebrastani -- vektorialgebra
petabitittään -- petabitti
kruununpolttimoltaan -- kruununpolttimo
nousijoissasi -- nousija
rummunlyöntieni -- rummunlyönti
verkostotopologialtanne -- verkostotopologia
virrakseni -- virta
toveissanne -- tovi
vinkkaamisistanne -- vinkkaaminen
vasallisuhdeettamme -- vasallisuhde
liikenneristeyksiltänne -- liikenneristeys
turistamisillaan -- turistaminen
kuudennuksittaan -- kuudennus
tallaantumisittani -- tallaantuminen
aromiterapianasi -- aromiterapia
jumalankuvassasi -- jumalankuva
marshalleistani -- marshall
seinähullussani -- seinähullu
tupsupäälaventeleillesi -- tupsupäälaventeli
budjettikehyksillemme -- budjettikehys
pirkkalalaisestaan -- pirkkalalainen
panenkefaliitillasi -- panenkefaliitti
kapinallisliikkeisiini -- kapinallisliike
kivennäisravinteilleni -- kivennäisravinne
keltakylkimedestäjiemme -- keltakylkimedestäjä
taklaamisellansa -- taklaaminen
testattavuudeltansa -- testattavuus
säälipisteilläni -- säälipiste
punajäkälissänne -- punajäkälä
räpäyksenäsi -- räpäys
atropiinimetonitraatteihinne -- atropiinimetonitraatti
henkilöunionillasi -- henkilöunioni
itsesyytöstänne -- itsesyytös
nivelkärsäisittänsä -- nivelkärsäiset
kiinihappoillasi -- kiinihappo
aistimuisteillanne -- aistimuisti
taistelutehtävinäni -- taistelutehtävä
säärisuojuksellansa -- säärisuojus
liu'uistamme -- liuku
fototypioistani -- fototypia
kataarilaisuudettasi -- kataarilaisuus
kalkkeestamme -- kalke
deodoranttisaippuoitanne -- deodoranttisaippua
teorianmuodostuksesi -- teorianmuodostus
konekivääripesäkkeestäni -- konekivääripesäke
areolastasi -- areola
yriteellämme -- yrite
silattanne -- sila
komediahahmonne -- komediahahmo
pohdiskelijaksemme -- pohdiskelija
ottomoottoriisi -- ottomoottori
trimekaiinejaan -- trimekaiini
sekkivihoikseen -- sekkivihko
keltasaransa -- keltasara
agglomeraatiltani -- agglomeraatti
naarasjoutseneltansa -- naarasjoutsen
kovuudeksenne -- kovuus
näytteitämme -- näyte
hoksaavaisuuksittansa -- hoksaavaisuus
rangaistusleiriään -- rangaistusleiri
kiislasianne -- kiislanen
graviksessamme -- gravis
japaninpäästäisiämme -- japaninpäästäinen
vankikarkurittamme -- vankikarkuri
seeltänsä -- see
kaariminuutillanne -- kaariminuutti
lähisukukieltäni -- lähisukukieli
suklaakermakaramellissamme -- suklaakermakaramelli
sitkankuusillesi -- sitkankuusi
virtsaamiskyvyttömyyksinäsi -- virtsaamiskyvyttömyys
merkitystunnistimettani -- merkitystunnistin
kuutamokävelyillenne -- kuutamokävely
tulostustoiminnollensa -- tulostustoiminto
harmaakurkkurastaihisi -- harmaakurkkurastas
leppäpensaallensa -- leppäpensas
kapinallisettasi -- kapinallinen
kusitolppanamme -- kusitolppa
öljyturmakseni -- öljyturma
maakuntalaulultansa -- maakuntalaulu
pimpsikivenänne -- pimpsikivi
voiteluvirheiltämme -- voiteluvirhe
galanteriastamme -- galanteria
kylmenemiseltäni -- kylmeneminen
aitiooni -- aitio
puhallusvilloinansa -- puhallusvilla
säätropismeilleen -- säätropismi
koiranulkoiluttajaltansa -- koiranulkoiluttaja
suostumattomuuksillenne -- suostumattomuus
vesisynnytyksiimme -- vesisynnytys
sosiaaliavustuksestani -- sosiaaliavustus
otsasaumoihisi -- otsasauma
lottopottejaan -- lottopotti
supersäieteoriojamme -- supersäieteoria
itseruoskinnoistani -- itseruoskinta
miasmastasi -- miasma
piplioilleen -- piplia
pyykkitelineilleen -- pyykkiteline
housumuoteiksenne -- housumuoti
sytytysjärjestelmäksensä -- sytytysjärjestelmä
kuullottamisellesi -- kuullottaminen
traakianfryygioiksesi -- traakianfryygia
vuoristokasvillisuutenasi -- vuoristokasvillisuus
linjahenkilöstöttämme -- linjahenkilöstö
salavaimostasi -- salavaimo
rotamisilliineinamme -- rotamisilliini
sieppaamisillansa -- sieppaaminen
reaktiivisuuttamme -- reaktiivisuus
lasiovillamme -- lasiovi
isäntärenkinämme -- isäntärenki
uskelalaisellensa -- uskelalainen
ratkaisuehdotuksessamme -- ratkaisuehdotus
puhenäyttämöstämme -- puhenäyttämö
jouluaamuansa -- jouluaamu
oireistollasi -- oireisto
käsinlatojallensa -- käsinlatoja
käsipalloiluittemme -- käsipalloilu
vedättäjinäsi -- vedättäjä
kivipaasinaan -- kivipaasi
spagaatistanne -- spagaati
enanteemilleni -- enanteema
vetämisinäni -- vetäminen
ooforosalpingektomiaksenne -- ooforosalpingektomia
revisioneuvokseni -- revisioneuvos
sitruunavatsanapsijoillansa -- sitruunavatsanapsija
pulterissasi -- pulteri
pajareittasi -- pajari
rasvapitoisuuteni -- rasvapitoisuus
rinnakkaiskanavieni -- rinnakkaiskanava
kerjäläisyytenänne -- kerjäläisyys
ilmastointiputkessanne -- ilmastointiputki
unbitriumiltanne -- unbitrium
alikohtasi -- alikohta
oktyylimyristaattiinne -- oktyylimyristaatti
hengitysteihimme -- hengitystie
rakennusjätteitänsä -- rakennusjäte
jalkapallokenttänne -- jalkapallokenttä
kapselikahveihinne -- kapselikahvi
panoraamattaan -- panoraama
ibadiitittamme -- ibadiitti
hivenlannoitteistanne -- hivenlannoite
pikkoniojemme -- pikkonia
korkoprosenteiksemme -- korkoprosentti
keskioluelleen -- keskiolut
aleneminamme -- alenema
matruusiksemme -- matruusi
tornikalloasi -- tornikallo
keinovalaistukseemme -- keinovalaistus
kvartettilaulunasi -- kvartettilaulu
loimusiioittani -- loimusiika
kirkkoherraltanne -- kirkkoherra
koetehdaattani -- koetehdas
nuijaseitikeittään -- nuijaseitikki
kuormantasauksellaan -- kuormantasaus
haikeani -- haikea
freoniltasi -- freoni
valtate'oiltanne -- valtateko
horoskopioillesi -- horoskopia
valtimotulehduksistaan -- valtimotulehdus
postimerkkikauppiaaltanne -- postimerkkikauppias
auringonkylvylläsi -- auringonkylpy
sulttaanittaressaan -- sulttaanitar
ajosuoriteeltanne -- ajosuorite
britannianenglanneissansa -- britannianenglanti
talonpoikaisjärkinämme -- talonpoikaisjärki
pintakulttuuriinne -- pintakulttuuri
omaishoitajilleen -- omaishoitaja
kuntorekiksenne -- kuntorekki
harsimapistoasi -- harsimapisto
nyypittämme -- nyyppä
vapaakiväärittämme -- vapaakivääri
baskialueistansa -- baskialue
hääväestään -- hääväki
aputyövoimassaan -- aputyövoima
höyläkoneeksenne -- höyläkone
keittiövälineihimme -- keittiöväline
äänekkyystasojenne -- äänekkyystaso
mesiadanoliasi -- mesiadanoli
soopelisiveltimenäsi -- soopelisivellin
editorinanne -- editori
pilante′ostamme -- pilanteko
vatsarasvassasi -- vatsarasva
fudosteiinistansa -- fudosteiini
kekolavastajiamme -- kekolavastaja
jalkapöydänluullansa -- jalkapöydänluu
suolamyllyiltäni -- suolamylly
lentoyhteydessämme -- lentoyhteys
sisaristossasi -- sisaristo
pimpsikiviltään -- pimpsikivi
perheenpäähämme -- perheenpää
sydänsairaastamme -- sydänsairas
dendrologioidemme -- dendrologia
mauritiuslaisekseen -- mauritiuslainen
laiminlyömisettämme -- laiminlyöminen
kloottikansiani -- kloottikannet
niiskauksissansa -- niiskaus
yllätyksestäni -- yllätys
sivuhommani -- sivuhomma
sottaisuutensa -- sottaisuus
laulukirjaltamme -- laulukirja
virhetermiksenne -- virhetermi
pikkuiseensa -- pikkuinen
akolioidensa -- akolia
jälkiruokalasinne -- jälkiruokalasi
konvektiovirtaustansa -- konvektiovirtaus
heikkovirtatekniikallani -- heikkovirtatekniikka
jäähdyttämöikseni -- jäähdyttämö
teutonilaisettani -- teutonilainen
hemolymfamme -- hemolymfa
vaihtolevyjeni -- vaihtolevy
sensoriksesi -- sensori
apteekkitavarallenne -- apteekkitavara
imputaatiollanne -- imputaatio
taittajiksesi -- taittaja
tallimestareillaan -- tallimestari
voimisillensa -- voiminen
omapäisyyksiksesi -- omapäisyys
koulutarvikkeihini -- koulutarvikkeet
turnauksellamme -- turnaus
tampopainoissaan -- tampopaino
kävijärekisteriltäsi -- kävijärekisteri
jalkaterissäsi -- jalkaterä
kihlalahjoihinne -- kihlalahja
ajatussuunniltani -- ajatussuunta
indeksirahastottasi -- indeksirahasto
lihaeineksistänsä -- lihaeines
lapsente´ottansa -- lapsenteko
parkunoissansa -- parkuna
inisuliinidefalaaneissaan -- inisuliinidefalaani
kannatusmaksuillanne -- kannatusmaksu
häikäisyinänne -- häikäisy
virityspuistamme -- virityspuu
suomukaklattajiksensa -- suomukaklattaja
sytkäreistämme -- sytkäri
teletöinänne -- teletyö
pragmaattisuudestasi -- pragmaattisuus
puutarhaletkuistamme -- puutarhaletku
kromiterästensä -- kromiteräs
materiaalitehokkuutenasi -- materiaalitehokkuus
kääntötakeiksenne -- kääntötakki
rikkarölleistäsi -- rikkarölli
glimepiridilläsi -- glimepiridi
sadekiitäjissäni -- sadekiitäjä
antifraasilleni -- antifraasi
mustinamultinaan -- mustamulta
lypsyastioilleni -- lypsyastia
ruskoissanne -- rusko
vihikoirallensa -- vihikoira
postmoderninasi -- postmoderni
sanahirviöitänne -- sanahirviö
alilämmöiltään -- alilämpö
soitinjohdantonamme -- soitinjohdanto
tekstipuhelimekseen -- tekstipuhelin
valkuaistarpeidenne -- valkuaistarve
maakuntahallituksekseni -- maakuntahallitus
vuokrataloalueestaan -- vuokrataloalue
taluttamisiamme -- taluttaminen
elintasokuiluttasi -- elintasokuilu
nuorena-miehenänsä -- nuorimies
poissulkemisesi -- poissulkeminen
hiekkapohjanasi -- hiekkapohja
tartarpihvikseen -- tartarpihvi
valtiattarillasi -- valtiatar
kansalaiskoululaisillasi -- kansalaiskoululainen
hohtokiveltanne -- hohtokivi
purjehdussäällään -- purjehdussää
sorvarinpensaihinsa -- sorvarinpensas
pikkuveneisiinsä -- pikkuvene
kaarisulkumerkeillenne -- kaarisulkumerkki
vehmaalaisiemme -- vehmaalainen
apofaasienne -- apofaasi
kriminalistiikkojeni -- kriminalistiikka
konstruktivistinne -- konstruktivisti
mäkiarhostanne -- mäkiarho
pilssivedettäsi -- pilssivesi
valtiontakauksekseni -- valtiontakaus
truveerejansa -- truveeri
väsähdyksillenne -- väsähdys
salapolttoomme -- salapoltto
äänittämisiään -- äänittäminen
maantuntumistaan -- maantuntuma
kontrollerisi -- kontrolleri
tasavajaaksesi -- tasavajaa
respektiäsi -- respekti
rajatilahäiriöiltämme -- rajatilahäiriö
karpalomorfillanne -- karpalomorfi
luokituksettaan -- luokitus
irvokkuuksiinsa -- irvokkuus
sekoitevilloiksemme -- sekoitevilla
alkuunpanijoikseen -- alkuunpanija
tuoksusimakkeenne -- tuoksusimake
drinkeittämme -- drinkki
konneveteläisekseni -- konneveteläinen
lausahtamiseltani -- lausahtaminen
pidätysoikeuteeni -- pidätysoikeus
palkkatukellamme -- palkkatuki
työaloiltaan -- työala
ystävästäsi -- ystävä
määrävähemmistöömme -- määrävähemmistö
soopeliturkkiimme -- soopeliturkki
karkottimianne -- karkotin
matkustuskieldollaan -- matkustuskielto
osakehintattasi -- osakehinta
myrkkykatkoissasi -- myrkkykatko
avaruusrakenteettasi -- avaruusrakenne
explorereinamme -- explorer
filisiinittään -- filisiini
ryyppyputkiesi -- ryyppyputki
rakkauskohtauksessansa -- rakkauskohtaus
keljuilijastani -- keljuilija
muovausleikkausteni -- muovausleikkaus
tripropyyleittänsä -- tripropyyli
väittäjäkseen -- väittäjä
tuskanhuudottani -- tuskanhuuto
teräksenharmaatani -- teräksenharmaa
suklaanapeissansa -- suklaanappi
tulisijojensa -- tulisija
vallankumouksellisuutenaan -- vallankumouksellisuus
heksyylidekanolittaan -- heksyylidekanoli
sävytesampoidenne -- sävytesampoo
soolokvartetillesi -- soolokvartetti
saippuakerroksettani -- saippuakerros
hoitoonmääräämispäätökselleen -- hoitoonmääräämispäätös
verhokankaattaan -- verhokangas
näennäisvaikutukseksenne -- näennäisvaikutus
valmistuspaikoillesi -- valmistuspaikka
aivotutkimuksiesi -- aivotutkimus
sulfokseillesi -- sulfoksi
puolisiskostani -- puolisisko
luonnonmarjoistamme -- luonnonmarja
työpituudellensa -- työpituus
autofobioittesi -- autofobia
savolaismallisiltaan -- savolaismallinen
kokemuspiirejänne -- kokemuspiiri
lopinaviireillemme -- lopinaviiri
houkkoasi -- houkko
pohjankarhuloreillensa -- pohjankarhulori
mankujallensa -- mankuja
ilmastodenialisteihisi -- ilmastodenialisti
valtionvelallenne -- valtionvelka
reaktoriimme -- reaktori
läänineläinlääkäreillenne -- läänineläinlääkäri
paikallavaluiltamme -- paikallavalu
kousseistamme -- koussi
punamulliksensa -- punamulta
disseminaatiostansa -- disseminaatio
lähilendoissanne -- lähilento
viuhahtamisittani -- viuhahtaminen
varovaisuusperiaateelleen -- varovaisuusperiaate
pelikielloiksenne -- pelikielto
shudriensa -- shudra
pentakloorifenoleinani -- pentakloorifenoli
gyraaseinani -- gyraasi
tapauskertomuksissanne -- tapauskertomus
tabascokilpikonnillaan -- tabascokilpikonna
kuiskaajaksesi -- kuiskaaja
sitruunankuoriani -- sitruunankuori
raakuutenanne -- raakuus
desentralisoinneistansa -- desentralisointi
ylilatauksekseni -- ylilataus